111111111111111111111111111111111111111111111111111111111111111111111111111111111111111111111111111111111111111111111111
1ECCCCCCCCCCCCCCCCCCCCCCCCCCCCCCCCCCCCC000000000000000000000000000000000000000000000000000000000000000000000000000000001
1CCCCCCCCCCCCCCCCCCCCCCCCCCCCCCCCCCCCCC000000000000000000000000000000000000000000000000000000000000000000000000000000001
1CCCCCCCCCCCCCCCCCCCCCCCCCCCCCCCCCCCCCC000000000000000000000000000000000000000000000000000000000000000000000000000000001
1CCCCCCCCCCCCCCCCCCCCCCCCCCCCCCCCCCCCCC000000000000000000000000000000000000000000000000000000000000000000000000000000001
1CCCCCCCCCCCCCCCCCCCCCCCCCCCCCCCCCCCCCC000000000000000000000000000000000000000000000000000000000000000000000000000000001
1CCCCCCCCCCCCCCCCCCCCCCCCCCCCCCCCCCCCCC000000000000000000000000000000000000000000000000000000000000000000000000000000001
1CCCCCCCCCCCCCCCCCCCCCCCCCCCCCCCCCCCCCC000000000000000000000000000000000000000000000000000000000000000000000000000000001
1CCCCCCCCCCCCCCCCCCCCCCCCCCCCCCCCCCCCCC000000000000000000000000000000000000000000000000000000000000000000000000000000001
1CCCCCCCCCCCCCCCCCCCCCCCCCCCCCCCCCCCCCC000000000000000000000000000000000000000000000000000000000000000000000000000000001
1CCCCCCCCCCCCCCCCCCCCCCCCCCCCCCCCCCCCCC000000000000000000000000000000000000000000000000000000000000000000000000000000001
1CCCCCCCCCCCCCCCCCCCCCCCCCCCCCCCCCCCCCC000000000000000000000000000000000000000000000000000000000000000000000000000000001
1CCCCCCCCCCCCCCCCCCCCCCCCCCCCCCCCCCCCCC000000000000000000000000000000000000000000000000000000000000000000000000000000001
1CCCCCCCCCCCCCCCCCCCCCCCCCCCCCCCCCCCCCC000000000000000000000000000000000000000000000000000000000000000000000000000000001
1CCCCCCCCCCCCCCCCCCCCCCCCCCCCCCCCCCCCCC000000000000000000000000000000000000000000000000000000000000000000000000000000001
1CCCCCCCCCCCCCCCCCCCCCCCCCCCCCCCCCCCCCC000000000000000000000000000000000000000000000000000000000000000000000000000000001
1CCCCCCCCCCCCCCCCCCCCCCCCCCCCCCCCCCCCCC000000000000000000000000000000000000000000000000000000000000000000000000000000001
1CCCCCCCCCCCCCCCCCCCCCCCCCCCCCCCCCCCCCC000000000000000000000000000000000000000000000000000000000000000000000000000000001
1CCCCCCCCCCCCCCCCCCCCCCCCCCCCCCCCCCCCCC000000000000000000000000000000000000000000000000000000000000000000000000000000001
1CCCCCCCCCCCCCCCCCCCCCCCCCCCCCCCCCCCCCC000000000000000000000000000000000000000000000000000000000000000000000000000000001
1CCCCCCCCCCCCCCCCCCCCCCCCCCCCCCCCCCCCCC000000000000000000000000000000000000000000000000000000000000000000000000000000001
1CCCCCCCCCCCCCCCCCCCCCCCCCCCCCCCCCCCCCP000000000000000000000000000000000000000000000000000000000000000000000000000000001
100000000000000000000000000000000000000000000000000000000000000000000000000000000000000000000000000000000000000000000001
100000000000000000000000000000000000000000000000000000000000000000000000000000000000000000000000000000000000000000000001
100000000000000000000000000000000000000000000000000000000000000000000000000000000000000000000000000000000000000000000001
100000000000000000000000000000000000000000000000000000000000000000000000000000000000000000000000000000000000000000000001
100000000000000000000000000000000000000000000000000000000000000000000000000000000000000000000000000000000000000000000001
100000000000000000000000000000000000000000000000000000000000000000000000000000000000000000000000000000000000000000000001
100000000000000000000000000000000000000000000000000000000000000000000000000000000000000000000000000000000000000000000001
100000000000000000000000000000000000000000000000000000000000000000000000000000000000000000000000000000000000000000000001
100000000000000000000000000000000000000000000000000000000000000000000000000000000000000000000000000000000000000000000001
100000000000000000000000000000000000000000000000000000000000000000000000000000000000000000000000000000000000000000000001
100000000000000000000000000000000000000000000000000000000000000000000000000000000000000000000000000000000000000000000001
100000000000000000000000000000000000000000000000000000000000000000000000000000000000000000000000000000000000000000000001
100000000000000000000000000000000000000000000000000000000000000000000000000000000000000000000000000000000000000000000001
100000000000000000000000000000000000000000000000000000000000000000000000000000000000000000000000000000000000000000000001
100000000000000000000000000000000000000000000000000000000000000000000000000000000000000000000000000000000000000000000001
100000000000000000000000000000000000000000000000000000000000000000000000000000000000000000000000000000000000000000000001
100000000000000000000000000000000000000000000000000000000000000000000000000000000000000000000000000000000000000000000001
100000000000000000000000000000000000000000000000000000000000000000000000000000000000000000000000000000000000000000000001
100000000000000000000000000000000000000000000000000000000000000000000000000000000000000000000000000000000000000000000001
100000000000000000000000000000000000000000000000000000000000000000000000000000000000000000000000000000000000000000000001
111111111111111111111111111111111111111111111111111111111111111111111111111111111111111111111111111111111111111111111111