11111111111111111
1CCCCCCCCCCCCCCC1
1CCCCCCCCCCCCCCC1
1PCCCCECCCCCCCCC1
1CCCCCCCCCCCCCCC1
1CCCCCCCCCCCCCCC1
1CCCCCCCCCCCCCCC1
11111111111111111