1111111111111
10000CCC10101
1P11111011111
1C00CC00CC001
1111111111E11
1111111111111